# https://en.wikipedia.org/wiki/List_of_ISO_3166_country_codes
alpha_2	name_long_en
AD	The Principality of Andorra
AE	The United Arab Emirates
AF	The Islamic Republic of Afghanistan
AG	Antigua and Barbuda
AI	Anguilla
AL	The Republic of Albania
AM	The Republic of Armenia
AO	The Republic of Angola
AQ	All land and ice shelves south of the 60th parallel south
AR	The Argentine Republic
AS	The Territory of American Samoa
AT	The Republic of Austria
AU	The Commonwealth of Australia
AW	Aruba
AX	Åland
AZ	The Republic of Azerbaijan
BA	Bosnia and Herzegovina
BB	Barbados
BD	The People's Republic of Bangladesh
BE	The Kingdom of Belgium
BF	Burkina Faso
BG	The Republic of Bulgaria
BH	The Kingdom of Bahrain
BI	The Republic of Burundi
BJ	The Republic of Benin
BL	The Collectivity of Saint-Barth‚lemy
BM	Bermuda
BN	The Nation of Brunei, the Abode of Peace
BO	The Plurinational State of Bolivia
BQ	Bonaire, Sint Eustatius and Saba
BR	The Federative Republic of Brazil
BS	The Commonwealth of The Bahamas
BT	The Kingdom of Bhutan
BV	Bouvet Island
BW	The Republic of Botswana
BY	The Republic of Belarus
BZ	Belize
CA	Canada
CC	The Territory of Cocos (Keeling) Islands
CD	The Democratic Republic of the Congo
CF	The Central African Republic
CG	The Republic of the Congo
CH	The Swiss Confederation
CI	The Republic of Cote d'Ivoire
CK	The Cook Islands
CL	The Republic of Chile
CM	The Republic of Cameroon
CN	The People's Republic of China
CO	The Republic of Colombia
CR	The Republic of Costa Rica
CU	The Republic of Cuba
CV	The Republic of Cabo Verde
CW	The Country of Cura‡ao
CX	The Territory of Christmas Island
CY	The Republic of Cyprus
CZ	The Czech Republic
DE	The Federal Republic of Germany
DJ	The Republic of Djibouti
DK	The Kingdom of Denmark
DM	The Commonwealth of Dominica
DO	The Dominican Republic
DZ	The People's Democratic Republic of Algeria
EC	The Republic of Ecuador
EE	The Republic of Estonia
EG	The Arab Republic of Egypt
EH	The Sahrawi Arab Democratic Republic
ER	The State of Eritrea
ES	The Kingdom of Spain
ET	The Federal Democratic Republic of Ethiopia
FI	The Republic of Finland
FJ	The Republic of Fiji
FK	The Falkland Islands
FM	The Federated States of Micronesia
FO	The Faroe Islands
FR	The French Republic
GA	The Gabonese Republic
GB	The United Kingdom of Great Britain and Northern Ireland
GD	Grenada
GE	Georgia
GF	Guyane
GG	The Bailiwick of Guernsey
GH	The Republic of Ghana
GI	Gibraltar
GL	Kalaallit Nunaat
GM	The Republic of The Gambia
GN	The Republic of Guinea
GP	Guadeloupe
GQ	The Republic of Equatorial Guinea
GR	The Hellenic Republic
GS	South Georgia and the South Sandwich Islands
GT	The Republic of Guatemala
GU	The Territory of Guam
GW	The Republic of Guinea-Bissau
GY	The Co-operative Republic of Guyana
HK	The Hong Kong Special Administrative Region of China
HM	The Territory of Heard Island and McDonald Islands
HN	The Republic of Honduras
HR	The Republic of Croatia
HT	The Republic of Haiti
HU	Hungary
ID	The Republic of Indonesia
IE	Ireland
IL	The State of Israel
IM	The Isle of Man
IN	The Republic of India
IO	The British Indian Ocean Territory
IQ	The Republic of Iraq
IR	The Islamic Republic of Iran
IS	Iceland
IT	The Italian Republic
JE	The Bailiwick of Jersey
JM	Jamaica
JO	The Hashemite Kingdom of Jordan
JP	Japan
KE	The Republic of Kenya
KG	The Kyrgyz Republic
KH	The Kingdom of Cambodia
KI	The Republic of Kiribati
KM	The Union of the Comoros
KN	Saint Kitts and Nevis
KP	The Democratic People's Republic of Korea
KR	The Republic of Korea
KW	The State of Kuwait
KY	The Cayman Islands
KZ	The Republic of Kazakhstan
LA	The Lao People's Democratic Republic
LB	The Lebanese Republic
LC	Saint Lucia
LI	The Principality of Liechtenstein
LK	The Democratic Socialist Republic of Sri Lanka
LR	The Republic of Liberia
LS	The Kingdom of Lesotho
LT	The Republic of Lithuania
LU	The Grand Duchy of Luxembourg
LV	The Republic of Latvia
LY	The State of Libya
MA	The Kingdom of Morocco
MC	The Principality of Monaco
MD	The Republic of Moldova
ME	Montenegro
MF	The Collectivity of Saint-Martin
MG	The Republic of Madagascar
MH	The Republic of the Marshall Islands
MK	Republic of North Macedonia
ML	The Republic of Mali
MM	The Republic of the Union of Myanmar
MN	The State of Mongolia
MO	Macao Special Administrative Region of China
MP	The Commonwealth of the Northern Mariana Islands
MQ	Martinique
MR	The Islamic Republic of Mauritania
MS	Montserrat
MT	The Republic of Malta
MU	The Republic of Mauritius
MV	The Republic of Maldives
MW	The Republic of Malawi
MX	The United Mexican States
MY	Malaysia
MZ	The Republic of Mozambique
NA	The Republic of Namibia
NC	New Caledonia
NE	The Republic of the Niger
NF	The Territory of Norfolk Island
NG	The Federal Republic of Nigeria
NI	The Republic of Nicaragua
NL	The Kingdom of the Netherlands
NO	The Kingdom of Norway
NP	The Federal Democratic Republic of Nepal
NR	The Republic of Nauru
NU	Niue
NZ	New Zealand
OM	The Sultanate of Oman
PA	The Republic of Panam 
PE	The Republic of Per£
PF	French Polynesia
PG	The Independent State of Papua New Guinea
PH	The Republic of the Philippines
PK	The Islamic Republic of Pakistan
PL	The Republic of Poland
PM	The Overseas Collectivity of Saint-Pierre and Miquelon
PN	The Pitcairn, Henderson, Ducie and Oeno Islands
PR	The Commonwealth of Puerto Rico
PS	The State of Palestine
PT	The Portuguese Republic
PW	The Republic of Palau
PY	The Republic of Paraguay
QA	The State of Qatar
RE	Reunion
RO	Romania
RS	The Republic of Serbia
RU	The Russian Federation
RW	The Republic of Rwanda
SA	The Kingdom of Saudi Arabia
SB	The Solomon Islands
SC	The Republic of Seychelles
SD	The Republic of the Sudan
SE	The Kingdom of Sweden
SG	The Republic of Singapore
SH	Saint Helena, Ascension and Tristan da Cunha
SI	The Republic of Slovenia
SJ	Svalbard and Jan Mayen
SK	The Slovak Republic
SL	The Republic of Sierra Leone
SM	The Republic of San Marino
SN	The Republic of Senegal
SO	The Federal Republic of Somalia
SR	The Republic of Suriname
SS	The Republic of South Sudan
ST	The Democratic Republic of S?o Tom‚ and Pr¡ncipe
SV	The Republic of El Salvador
SX	Sint Maarten
SY	The Syrian Arab Republic
SZ	The Kingdom of Eswatini
TC	The Turks and Caicos Islands
TD	The Republic of Chad
TF	The French Southern and Antarctic Lands
TG	The Togolese Republic
TH	The Kingdom of Thailand
TJ	The Republic of Tajikistan
TK	Tokelau
TL	The Democratic Republic of Timor-Leste
TM	Turkmenistan
TN	The Republic of Tunisia
TO	The Kingdom of Tonga
TR	The Republic of Turkey
TT	The Republic of Trinidad and Tobago
TV	Tuvalu
TW	The Republic of China
TZ	The United Republic of Tanzania
UA	Ukraine
UG	The Republic of Uganda
UM	BakerIsland, HowlandIsland, JarvisIsland, JohnstonAtoll, KingmanReef, MidwayAtoll, NavassaIsland, PalmyraAtoll, and WakeIsland
US	The United States of America
UY	The Oriental Republic of Uruguay
UZ	The Republic of Uzbekistan
VA	The Holy See
VC	Saint Vincent and the Grenadines
VE	The Bolivarian Republic of Venezuela
VG	The Virgin Islands
VI	The Virgin Islands of the United States
VN	The Socialist Republic of Viet Nam
VU	The Republic of Vanuatu
WF	The Territory of the Wallis and Futuna Islands
WS	The Independent State of Samoa
YE	The Republic of Yemen
YT	The Department of Mayotte
ZA	The Republic of South Africa
ZM	The Republic of Zambia
ZW	The Republic of Zimbabwe
